00000000000
01010101010
00101010100
01010101010
00101010100
01010101010
00101010100
01010101010
00101010100
01010101010
00101010100