00101010100
02020212120
00000000100
02020202020
00000001000
02020202020
00000000000
02020202020
00000000000
02020202020
00000000000