00101100100
02020212121
00010000100
02020212020
00100111010
02021212020
00100100101
02120212020
00010100100
02020212120
00101101001